OOOOOOOOOOOOOOOOPPPPPPPPPPPPPPPPPPPPPPPPPPPPPPPPPP
OOOOOOPPPPPPPPPPPOOOOOOOOOOOOOOOOOOOOOOOOOOOOOOOOP
OOOOOOPOOOOOOOOOPOOOOOOOOOOOOOOOOOOOOOOOOOOOOOOOOP
OOOOOOPOOOOOOOOOPOOOOOOOOOOOOOOOOOOOOOOOOOOOOOOOOP
OOOOOOPOOOOOOOOOPOOOOOOOOOOOOOOOOOOOOOOOOOOOOOOOOP
OOOOOOPOOOOOOOOOPOOOOOOOOOOOOOOOOOOOOOOOOOOOOOOOOF
OOOOOOPOOOOOOOOOPOOOOOOOOOOOOOOOOOOOOOOOOOOOOOOOOO
OOOOOOPPPPPPPPPPPOOOOOOOOOOOOOOOOOOOOOOOOOOOOOOOOO
OOOOOOPOOOOOOOOOOOOOOOOOOOOOOOOOOOOOOOOOOOOOOOOOOO
PPPPPPPOOOOOOOOOOOOOOOOOOOOOOOOOOOOOOOOOOOOOOOOOOO
OOOOOOPOOOOOOOOOOOOOOOOOOOOOOOOOOOOOOOOOOOOOOOOOOO
OOOOOOPPPPPPPPPPPOOOOOOOOOOOOOOOOOOOOOOOOOOOOOOOOO
OOOOOOPOOOOOOOOOPOOOOOOOOOOOOOOOOOOOOOOOOOOOOOOOOO
OOOOOOPOOOOOOOOOPOOOOOOOOOOOOOOOOOOOOOOOOOOOOOOOOO
OOOOOOPOOOOOOOOOPOOOOOOOOOOOOOOOOOOOOOOOOOOOOOOOOO
OOOOOOPOOOOOOOOOPOOOOOOOOOOOOOOOOOOOOOOOOOOOOOOOOO
OOOOOOPOOOOOOOOOPOOOOOOOOOOOOOOOOOOOOOOOOOOOOOOOOO
POOOOOPPPPPPPPPPPOOOOOOOOOOOOOOOOOOOOOOOOOOOOOOOOO
POOOOOPOOOOOOOOOOOOOOOOOOOOOOOOOOOOOOOOOOOOOOOOOOO
PPPPPPPOOOOOOOOOOOOOOOOOOOOOOOOOOOOOOOOOOOOOOOOOOO
OOOOOOPOOOOOOOOOOOOOOOOOOOOOOOOOOOOOOOOOOOOOOOOOOO
OOOOOOPPPPPPPPPPPOOOOOOOOOOOOOOOOOOOOOOOOOOOOOOOOO
OOOOOOPOOOOOOOOOPOOOOOOOOOOOOOOOOOOOOOOOOOOOOOOOOO
OOOOOOPOOOOOOOOOPOOOOOOOOOOOOOOOOOOOOOOOOOOOOOOOOO
OOOOOOPOOOOOOOOOPOOOOOOOOOOOOOOOOOOOOOOOOOOOOOOOOO
OOOOOOPOOOOOOOOOPOOOOOOOOOOOOOOOOOOOOOOOOOOOOOOOOO
OOOOOOPOOOOOOOOOPOOOOOOOOOOOOOOOOOOOOOOOOOOOOOOOOO
OOOOOOPPPPPPPPPPPOOOOOOOOOOOOOOOOOOOOOOOOOOOOOOOOO
OOOOOOPOOOOOOOOOOOOOOOOOOOOOOOOOOOOOOOOOOOOOOOOOOO
PPPPPPPOOOOOOOOOOOOOOOOOOOOOOOOOOOOOOOOOOOOOOOOOOO
OOOOOOPOOOOOOOOOOOOOOOOOOOOOOOOOOOOOOOOOOOOOOOOOOO
OOOOOOPPPPPPPPPPPOOOOOOOOOOOOOOOOOOOOOOOOOOOOOOOOO
OOOOOOPOOOOOOOOOPOOOOOOOOOOOOOOOOOOOOOOOOOOOOOOOOO
OOOOOOPOOOOOOOOOPOOOOOOOOOOOOOOOOOOOOOOOOOOOOOOOOO
OOOOOOPOOOOOOOOOPOOOOOOOOOOOOOOOOOOOOOOOOOOOOOOOOO
OOOOOOPOOOOOOOOOPOOOOOOOOOOOOOOOOOOOOOOOOOOOOOOOOO
OOOOOOPOOOOOOOOOPOOOOOOOOOOOOOOOOOOOOOOOOOOOOOOOOO
PPPPPPPPPPPPPPPPPPPPPPPPPPPPPPPPOOOOOOOOOOOOOOOOOO
POOOOOOOOOOOOOOOOOOOOOOOOOOOOOOPOOOOOOOOOOOOOOOOOO
PPPPPPPPPPOOOOOOPPPPPPPPPPPPPPPPOOOOOOOOOOOOOOOOOO
OOOOOOOOOPOOOOOOPOOOOOOOOOOOOOOOOOOOOOOOOOOOOOOOOO
OOOOOOPPPPPPPPPPPOOOOOOOOOOOOOOOOOOOOOOOOOOOOOOOOO
OOOOOOPOOOOOOOOOPOOOOOOOOOOOOOOOOOOOOOOOOOOOOOOOOO
OOOOOOPOOOOOOOOOPOOOOOOOOOOOOOOOOOOOOOOOOOOOOOOOOO
OOOOOOPOOOOOOOOOPOOOOOOOOOOOOOOOOOOOOOOOOOOOOOOOOO
OOOOOOPOOOOOOOOOPOOOOOOOOOOOOOOOOOOOOOOOOOOOOOOOOO
OOOOOOPOOOOOOOOOPOOOOOOOOOOOOOOOOOOOOOOOOOOOOOOOOO
OOOOOOPPPPPPPPPPPOOOOOOOOOOOOOOOOOOOOOOOOOOOOOOOOO
OOOOOOPOOOOOOOOOOOOOOOOOOOOOOOOOOOOOOOOOOOOOOOOOOO
PPPPPPPOOOOOOOOOOOOOOOOOOOOOOOOOOOOOOOOOOOOOOOOOOO