OOOOOOOOOO
OOOOOOPPPF
OOOOOOPOOP
OOOOOOPOOP
OOOOOOPOOP
OOOOOOPOOP
OOOOOOPOOP
PPPPPPPPPP
POOOOOOOOO
POOOOOOOOO